_______________________________________________________________________________
_______________________________________________________________________________
_________________X_____________________________________________________________
_________________XX____________________________________________________________
___________XXXXXXXXX___________________________________________________________
___________XXXXXXXXXX__________________________________________________________
___________XXXXXXXXX___________________________________________________________
_________________XX____________________________________________________________
_________________X_____________________________________________________________
_______________________________________________________________________________
_______________________________________________________________________________
_________________________________________________________________C_____________
_____________________________________________________________XXXXX_____________
_______________________________XX___________________XXXXX______________________
_______________________________________________________________________________
_______________________________________________________________________________
XXXXXXX___P____XXXXXXXXXXXXXX______XXXXXXX_______XXXXXXXXXXX___________________
XXXXXXXXXXXX__XXXXXXXXXXXXXXX______XXXXXXXXXXXXXXXXXXXXXXXXXXXXXXXXXXXXXXXXXXXX